####### ########    ###################
#.....# #......######.................#
#.....|.|......|....|.................#
#.....# #......######.................#
####### ####|###    #########|#########
           #.#              #.# 
           #.#              #.#
           #.#              #.#
           #.#              #.#
           #.#              #.#
           #.#              #.#
           #.#              #.#
############.################|########################################
#....................................................................#
#....................................................................#
#....................................................................#
#........@.......R...................................................#
#................S...................................................#
#....................................................................#
#....................................................................#
#....................................................................#
#....................................................................#
#....................................................................#
#....................................................................#
######################################################################