####### ########    ###################
#.....# #......######.................#
#.....|.|......|....|.................#
#.....# #......######.................#
####### ####|###    #########|#########
           #.#              #.# 
           #.#              #.#
           #.#              #.#
           #.#              #.#
           #.#              #.#
           #.#              #.#
           #.#              #.#
############|################|########################################
#.............h......................................................#
#....................................................................#
#....................................................................#
#........@.................d.........................................#
#....................................................................#
#...................................R................................#
#..................s.................................................#
#....................................................................#
#....................................................................#
#....................................................................#
#....................................................................#
######################################################################