####### ########
#.....# #......#
#..P..|.|......#
#.....# #......#
####### ####|###
           #.#
           #.#
           #.#
           #.#
           #.#
           #.#
           #.#
############.#########################################################
#....................................................................#
#....................................................................#
#....................................................................#
#....................................................................#
#....................................................................#
#....................................................................#
#....................................................................#
#....................................................................#
#....................................................................#
#....................................................................#
#....................................................................#
######################################################################