###################
#.................#
#.................#        
#........u........#
#.................#
#.................#
###################