####### ########
#.....# #......#
#.....|.|......#
#.....# #......#
####### ########