####### ########    ###################
#.....# #......######.................#
#..@..|.|..R...|....|.................#
#.....# #......######.................#
####### ####|###    #########|#########
           #.#              #.# 
           #.#              #.#
           #.#              #.#
           #.#              #.#
           #.#              #.#
           #.#              #.#
           #.#              #.#
############.################|########################################
#....................................................................#
#....................................................................#
#..............................................S.....................#
#............S.......................................................#
#....................................................................#
#..............................S.....................................#
#....................................................................#
#....................................................................#
#....................................................................#
#........S...........................................................#
#....................................................................#
######################################################################